#detail from:http://unix.stackexchange.com/questions/43539/what-do-the-flags-in-proc-cpuinfo-mean

3dnow: 3DNow! (AMD vector instructions, competing with Intel's SSE1)
3dnowext: AMD 3DNow! extensions
3dnowprefetch: 3DNow prefetch instructions
abm: Advanced Bit Manipulation
ace2: Advanced Cryptography Engine v2
ace2_en: ACE v2 enabled
ace: on-CPU crypto (xcrypt)
ace_en: on-CPU crypto enabled
acpi: ACPI via MSR (temperature monitoring and clock speed modulation)
adx: The ADCX and ADOX instructions
aes/aes-ni: Advanced Encryption Standard (New Instructions)
amd_dcm: multi-node processor
aperfmperf: APERFMPERF
apic: Onboard APIC
arat: Always Running APIC Timer
arch_perfmon: Intel Architectural PerfMon
avx2: AVX2 instructions
avx: Advanced Vector Extensions
bmi1: 1st group bit manipulation extensions
bmi2: 2nd group bit manipulation extensions
bts: Branch Trace Store
centaur_mcr: Centaur MCRs (= MTRRs)
cid: Context ID
clflush: Cache Line Flush instruction
cmov: CMOV instructions (conditional move) (also FCMOV)
cmp_legacy: If yes HyperThreading not valid
constant_tsc: TSC ticks at a constant rate
cpb: AMD Core Performance Boost
cr8_legacy: CR8 in 32-bit mode
cx16: CMPXCHG16B
cx8: CMPXCHG8 instruction (64-bit compare-and-swap)
cxmmx: Cyrix MMX extensions
cyrix_arr: Cyrix ARRs (= MTRRs)
dca: Direct Cache Access
de: Debugging Extensions (CR4.DE)
decodeassists: AMD Decode Assists support
ds_cpl: CPL Qual. Debug Store
dtes64: 64-bit Debug Store
dts: Debug Store (buffer for debugging and profiling instructions)
dts: Digital Thermal Sensor
eagerfpu: Non lazy FPU restore
epb: IA32_ENERGY_PERF_BIAS support
ept: Intel Extended Page Table
erms: Enhanced REP MOVSB/STOSB
est: Enhanced SpeedStep
extapic: Extended APIC space
extd_apicid: has extended APICID (8 bits)
f16c: 16-bit fp conversions (CVT16)
flexpriority: Intel FlexPriority
flushbyasid: AMD flush-by-ASID support
fma4: 4 operands MAC instructions
fma: Fused multiply-add
fpu: Onboard FPU (floating point support)
fsgsbase: {RD/WR}{FS/GS}BASE instructions
fxsr: FXSAVE/FXRSTOR, CR4.OSFXSR
fxsr_opt: FXSAVE/FXRSTOR optimizations
hle: Hardware Lock Elision
ht: Hyper-Threading
hw_pstate: AMD HW-PState
hypervisor: Running on a hypervisor
ia64: Intel Itanium Architecture 64-bit (not to be confused with Intel's 64-bit x86 architecture with flag x86-64 or "AMD64" bit indicated by flag lm)
ibs: Instruction Based Sampling
ida: Intel Dynamic Acceleration
intel_pt: Intel Processor Tracing
invpcid: Invalidate Processor Context ID
k6_mtrr: AMD K6 nonstandard MTRRs
lahf_lm: Load AH from Flags (LAHF) and Store AH into Flags (SAHF) in long mode
lbrv: AMD LBR Virtualization support
lm: Long Mode (x86-64: amd64, also known as Intel 64, i.e. 64-bit capable)
longrun: Longrun power control
lrti: LongRun table interface
lwp: Light Weight Profiling
mca: Machine Check Architecture
mce: Machine Check Exception
misalignsse: Misaligned SSE mode
mmx: Multimedia Extensions
mmxext: AMD MMX extensions
monitor: Monitor/Mwait support (Intel SSE3 supplements)
movbe: Move Data After Swapping Bytes instruction
mp: Multiprocessing Capable.
mpx: Memory Protection Extension
msr: Model-Specific Registers (RDMSR, WRMSR)
mtrr: Memory Type Range Registers
nodeid_msr: NodeId MSR
nonstop_tsc: TSC does not stop in C states
nonstop_tsc_s3: TSC doesn't stop in S3 state
nopl: The NOPL (0F 1F) instructions
npt: AMD Nested Page Table support
nrip_save: AMD SVM next_rip save
nx: Execute Disable
osvw: OS Visible Workaround
pae: Physical Address Extensions (support for more than 4GB of RAM)
pat: Page Attribute Table
pausefilter: AMD filtered pause intercept
pbe: Pending Break Enable (PBE# pin) wakeup support
pcid: Process Context Identifiers
pclmulqdq: Perform a Carry-Less Multiplication of Quadword instruction — accelerator for GCM)
pdcm: Performance Capabilities
pdpe1gb: One GB pages (allows hugepagesz=1G)
pebs: Precise-Event Based Sampling
perfctr_core: Core Performance Counter Extensions
perfctr_l2: L2 Performance Counter Extensions
perfctr_nb: NB Performance Counter Extensions
pfthreshold: AMD pause filter threshold
pge: Page Global Enable (global bit in PDEs and PTEs)
phe: PadLock Hash Engine
phe_en: PHE enabled
pln: Intel Power Limit Notification
pmm: PadLock Montgomery Multiplier
pmm_en: PMM enabled
pn: Processor serial number
pni: SSE-3 (“Prescott New Instructions”)
popcnt: Return the Count of Number of Bits Set to 1 instruction (Hamming weight, i.e. bit count)
proc_feedback: AMD ProcFeedbackInterface
pse36: 36-bit PSEs (huge pages)
pse: Page Size Extensions (4MB memory pages)
pts: Intel Package Thermal Status
rdrand: Read Random Number from hardware random number generator instruction
rdseed: The RDSEED instruction
rdtscp: Read Time-Stamp Counter and Processor ID
recovery: CPU in recovery mode
rep_good: rep microcode works well
rng: Random Number Generator present (xstore)
rng_en: Random Number Generator enabled
rtm: Restricted Transactional Memory
sep: SYSENTER/SYSEXIT
skinit: SKINIT/STGI instructions
smap: Supervisor Mode Access Prevention
smep: Supervisor Mode Execution Protection
smx: Safer mode: TXT (TPM support)
ss: CPU self snoop
sse2: SSE2
sse4_1: SSE-4.1
sse4_2: SSE-4.2
sse4a: SSE-4A
sse: Intel SSE vector instructions
ssse3: Supplemental SSE-3
svm: “Secure virtual machine”: AMD-V
svm_lock: AMD SVM locking MSR
syscall: SYSCALL (Fast System Call) and SYSRET (Return From Fast System Call)
tbm: Trailing Bit Manipulation
tce: translation cache extension
tm2: Thermal Monitor 2
tm: Automatic clock control (Thermal Monitor)
topoext: Topology Extensions CPUID leafs
tpr_shadow: Intel TPR Shadow
tsc: Time Stamp Counter (RDTSC)
tsc_deadline_timer: Tsc deadline timer
tsc_reliable: TSC is known to be reliable
tsc_scale: AMD TSC scaling support
up: smp kernel running on up
vmcb_clean: AMD VMCB clean bits support
vme: Virtual Mode Extensions (8086 mode)
vmx: Hardware virtualization: Intel VMX
vnmi: Intel Virtual NMI
vpid: Intel Virtual Processor ID
wdt: Watchdog timer
x2apic: x2APIC
xop: extended AVX instructions
xsave: Save Processor Extended States: also provides XGETBY,XRSTOR,XSETBY
xsaveopt: Optimized Xsave
xtopology: cpu topology enum extensions
xtpr: Send Task Priority Messages
